#######
#*#***#
S*#*#*#
#*#*#*#
#***#*G
#*###*#
#######
