#######
#*#***#
**#*#*#
#*#*#*#
#***#**
#*###*#
#######